// 元数据区
版本号：1.0.1
维护者：maenora
更新时间：2025-10-14
// 人名地名等专有名词，此区域区分大小写
Jon Snow = 琼恩·雪诺
Visenya Targaryen = 维桑尼亚·坦格利安
Roose Bolton = 卢斯·波顿	
Domeric Bolton =	多米利克·波顿	
Ramsay Snow	= 拉姆斯·雪诺
Bethany Ryswell =	蓓珊妮·莱斯威尔
Arya Stark	= 艾莉亚·史塔克	
Bran Stark	= 布兰·史塔克
Rickon Stark	= 瑞肯·史塔克	
Catelyn Tully	= 凯特琳·徒利
Rhaella Targaryen	= 雷拉·坦格利安
Alannys Harlaw	= 亚拉妮丝·哈尔洛
Gerold Lannister = 杰洛·兰尼斯特
Lharys	= 拉利斯
Edmyn Tully	= 艾德敏·徒利
Frenken = 法兰肯  
Rhaella Targaryen = 雷拉·坦格利安  
Milady's Supper = 贵妇的晚餐  
cave of the three-eyed crow = 三眼乌鸦的洞穴  
Tourneys = 比武大会  
Alannys Harlaw = 亚拉妮丝·哈尔洛  
Garth  = 加尔斯  
Gerold Lannister = 杰洛·兰尼斯特  
Lharys = 拉利斯  
Edmyn Tully = 艾德敏·徒利  
Runes = 符文  
Loptail = 断尾  
Arrax = 阿拉克斯  
Gunthor = 冈梭尔  
Seven Drunken Oarsmen = 醉酒七桨手  
Ramsford = 公羊渡  
Kaeth = 喀斯  
Warlocks = 男巫  
Helicent  = 梅森特  
Heart's Home = 心宿城  
Murmison = 墨密森  
Osha = 欧莎  
House Mudd = 穆德家族  
Urrigon Greyjoy = 乌尔刚·葛雷乔伊  
Jocelyn Swyft = 乔斯琳·史威佛  
Lanna Lannister = 拉娜·兰尼斯特  
Shadow Lands = 阴影之地  
Jon Penrose = 琼恩·庞洛斯  
Keyholders = 看匙人  
Robin Potter = 罗伯特·波特  
House Orkwood = 奥克伍家族  
Humfrey Waters = 亨佛利·维水  
Robar Baratheon = 罗拔·拜拉席恩  
Whalen Frey = 惠伦·佛雷  
Stone Hedge = 石篱城  
Harvest feast = 丰收宴会  
Dawn = 黎明  
Otho Bracken = 奥瑟·布雷肯  
Cleon the Second = 克莱昂二世  
Tyta Frey = 坦雅·佛雷  
Six Sorrows = 六件悲伤的往事  
House Cerwyn = 赛文家族  
Brindlewood = 野猪林  
House Bettley = 本特利家族  
Blood and Fire = 血与火  
Gran Goodbrother = 葛蓝·古柏勒  
Lancel Lannister  = 蓝赛尔·兰尼斯特  
Renly Baratheon = 蓝礼·拜拉席恩  
Pypar = 派普尔  
Jacaerys Velaryon = 杰卡里斯·瓦列利安  
Guildhall of the Alchemists = 炼金术士的公会大厅  
Sea of Myrth = 密尔海  
Stag of the Sea = 海鹿号  
Tywin Frey = 泰温·佛雷  
Dragonmont = 龙山  
Darkwash = 暗流河  
Zharaq zo Loraq = 扎那克·佐·洛拉克  
Barsena = 巴尔塞娜  
Walda Frey = 瓦妲·佛雷
House Bywater = 拜瓦特家族
Rain House = 雨屋城
Geoff = 高夫
House Longthorpe = 朗多普家族
House Bywater = 拜瓦特家族
Rain House = 雨屋城
Geoff = 高夫
House Longthorpe = 朗多普家族
Harlaw Hall = 哈尔洛厅
Tyrion Lannister = 提利昂·兰尼斯特
House Fossoway = 佛索威家族
Owen Norrey = 欧文·诺瑞
Tower of Joy = 极乐塔
Jacelyn Bywater = 杰斯林·拜瓦特
Emmond = 埃蒙德
Chataya's brothel = 莎塔雅的妓院
House Harclay = 哈克莱氏族
House Lychester = 莱彻斯特家族
Lady’s Lace = 仕女蕾丝
Landing of the Golden Company = 黄金团登陆
Sharp Point = 尖角
Iron Holt = 铁林城
Volaenia = 瓦兰娜河
Dragonkin, Being a History of House Targaryen from Exile to Apotheosis, with a Consideration of the Life and Death of Dragons = 龙王们：坦格利安家族从流浪到神化的历程，兼论巨龙之生死
Artos Stark = 阿托斯·史塔克
A Dream of Spring = 春晓的梦想
Coldwater Burn = 冷水城
Tyrosh = 泰洛西
House Hogg = 霍格家族
Tyene Sand = 特蕾妮·沙德
House Peasebury = 比兹伯利家族
Church of Starry Wisdom = 群星就位教
Three Whores = 君临三妓
Ethan Glover = 伊森·葛洛佛
Quaithe = 魁蜥
Selwyn Tarth = 塞尔温·塔斯
Sailor's Sept = 水手圣堂
Catelyn Stark = 凯特琳·史塔克
House Sarwyck of Riverspring = 萨威克家族
Will of the Woods = 林地的威尔
Orphans of the Greenblood = 绿血河的孤儿
Rills = 溪流地
House Gower = 高尔家族
Queen of Love and Beauty = 爱与美的王后
A Cask of Ale = 一桶麦酒
Ulwyck Uller = 乌里克·乌勒
Goghor = 格鲁尔
Harlon Stark = 哈龙·史塔克
Karlon Stark = 卡隆·史塔克
Norbert Vance = 诺勃特·凡斯
Clarence Crabb = 克莱伦斯·克莱勃
Golden Fields = 黄金原野
Wylla = 薇拉
Dickon Manwoody = 狄肯·曼伍笛
Fornio = 佛尼奥
Pate = 佩特
Tanselle = 坦茜莉
Raymund Tyrell = 雷蒙德·提利尔
Porther = 波瑟
Fingerdancer = 手指舞号
Valyrian Freehold = 瓦雷利亚自由堡垒
Sevenstreams = 七泉镇
Jaehaerys Targaryen = 杰赫里斯·坦格利安
Fair Isle = 仙女岛
Kraznys mo Nakloz = 克拉兹尼·莫·纳克罗兹
Valysar = 瓦利萨
Kingsguard = 御林铁卫
House Sunderly = 桑德利家族
Kingspyre Tower = 焚王塔
Qarkash = 魁卡西
Arbor Queen = 青亭女王号
Watt = 瓦特
The Twins = 孪河城
Wintercake = 冬糕
Disputed Lands = 争议之地
House Gaunt = 戈特家族
Riverlands = 河间地
Bryan Fossoway = 布赖恩·佛索威
Jon Brax = 琼恩·布拉克斯
House Redwyne = 雷德温家族
Karl = 卡尔
Jarl = 贾尔
Leslyn = 勒斯林
Carellen Smallwood = 凯瑞琳·斯莫伍德
Cornfield = 玉米城
House Foote = 福特家族
Leona Tyrell = 里雅·提利尔
House Waxley = 魏克利家族
Mariya Darry = 玛丽亚·戴瑞
Robb Stark = 罗柏·史塔克
Dornish Marches = 多恩边疆地
Ralf of Lordsport = 君王港的拉弗
Carcosa = 卡科萨
House Pyne = 潘恩家族
False Spring = 错误的春天
Denys Strong = 丹尼斯·斯壮
Laughing Lord = 欢笑君王号
Danwell Frey = 丹威尔·佛雷
Anguy = 安盖
Selhorys = 赛荷鲁镇
Prickly Ben = 刺辣木
Pendric Hills = 彭德瑞丘陵
Oznak zo Pahl = 欧兹纳克·佐·帕尔
Erreck = 艾瑞克
Holger = 霍格
House Selmy = 赛尔弥家族
Alysanne Bulwer = 亚莉珊·布尔威
Sailor's Wife = 水手之妻
House Dayne = 戴恩家族
Spiceflower = 香料花
House Farring = 法林家族
Otto Hightower = 奥托·海塔尔
Brandon Norrey  = 布兰登·诺瑞
Hearteater = 噬心
Shadowcat (constellation) = 影子山猫座
Gawen Glover = 加文·葛洛佛
Galazza Galare = 格拉茨旦·卡拉勒
Battle of Deepwood Motte = 偷袭深林堡
House Harroway = 哈罗威家族
Ollo Lophand = 独臂奥罗
House Jordayne = 乔戴恩家族
Mordane = 茉丹
Garth = 加尔斯
Warden of the West = 西境守护
Seastone Chair = 海石之位
Ragnor Pyke = 拉格诺·派克
Daena Targaryen = 戴安娜·坦格利安
Rat Cook = 鼠厨师
Quentin Tyrell = 昆丁·提利尔
Triston Sunderland = 崔斯顿·桑德兰
House Grell = 格瑞尔家族
Malora Hightower = 莫罗娅·海塔尔
Bayard Norcross = 拜亚德·诺科斯
Allaquo = 艾拉括
House of Uhlez = 乌尔兹家族
Warrens = 庇圣所
The greens = 绿党
Lady Lyanna = 莱安娜小姐号
Morning = 晨光
Rickon Stark = 瑞肯·史塔克
Tommen Tully = 托曼·徒利
Egon Emeros = 艾耿·艾摩若
House Serrett = 沙略特家族
Tourney at Lannisport = 兰尼斯港比武大会
Bodger = 波吉
Jeyne Rivers = 简妮·河文
Moonbloom = 月花
Titan's Daughter = 泰坦之女号
Dake = 戴克
Jocelyn Penrose = 乔斯琳·庞洛斯
Hake = 哈克
House Santagar = 桑塔加家族
Myrish fire = 密尔火
Joffrey Lannister = 乔佛里·兰尼斯特
Maidenpool = 女泉镇
Erryk Cargyll = 伊利克·卡盖尔
Vaes Tolorro = 维斯·托罗若
Arryk Cargyll = 亚历克·卡盖尔
Talla Tarly = 塔拉·塔利
Aegon Targaryen = 伊耿·坦格利安
Crackclaw Point = 蟹爪半岛
House Vyrwel = 莱维尔家族
Ronald Connington = 罗纳德·克林顿
Band of Nine = 九人团
harpy = 鹰身女妖
Humfrey Hardyng = 亨佛利·哈顿
Isle of Toads = 蛤蟆岛
Vase Efe = 维斯·伊芙
Fist of the First Men = 先民拳峰
Andalos = 安达斯
Boneway = 骨路
Orland of Oldtown = 旧镇的奥兰多
Sallei Paege = 莎蕾·培吉
Womb of the World = 世界的子宫
Maegi = 巫魔女
Seven Skulls = 七颗头骨号
Steffon Seaworth = 史蒂芬·席渥斯
Armond Caswell = 阿尔蒙·卡斯威
Children's Tower = 森林之子塔
Eddara Tallhart = 艾妲·陶哈
Swift Sword = 快剑号
Golden Company = 黄金团
Barrowlands = 先民荒冢
Driftwood Hall = 浮木厅
Aladale Wynch = 阿拉达·温奇
Norjen = 诺京
House Hightower = 海塔尔家族
House Stark = 史塔克家族
Brazen Beasts = 兽面军
King's Landing = 君临
Cerelle Lannister = 瑟蕾拉·兰尼斯特
Shadowcat = 影子山猫
Anders Yronwood = 安德斯·伊伦伍德
Hoster Frey = 霍斯特·佛雷
Brynden Blackwood = 布林登·布莱伍德
Lord Sweet = 斯维特伯爵
Jon Charlton = 琼恩·查尔顿
Standfast = 坚定堡
Sheepshead Hills = 羊头山
House Charlton = 查尔顿家族
Omer Florent = 欧麦·佛罗伦
Glendon Hewett = 葛兰登·赫威特
Unella = 乌尼亚
Stallion Who Mounts the World = 骑着世界的骏马
House Thorne = 索恩家族
Rhea Royce = 雷娅·罗伊斯
Rickard Karstark = 瑞卡德·卡史塔克
Dragonbone = 龙骨
House Grafton = 格拉夫森家族
House Broom = 布隆家族
Cromm = 科洛姆
Denys Redwyne = 戴尼斯·雷德温
Erren Florent = 伊伦·佛罗伦
Dickon Tarly = 狄肯·塔利
Lives of the High Septons = 历代总主教纪事
Glass candle = 玻璃蜡烛
Roger Ryswell = 罗尔杰·莱斯威尔
Daella Targaryen = 丹妮菈·坦格利安
Amarei Crakehall = 阿梅丽·克雷赫
Chella = 齐拉
Raynald Westerling = 雷纳德·维斯特林
Ten Towers = 十塔城
Wenda = 温妲
Stallion heart = 马心
Laena Penrose = 兰娜尔·庞洛斯
Rhea Florent = 雷娅·佛罗伦
House Cockshaw = 库克肖家族
House Casterly = 凯斯德利家族
Rickard Wylde = 里查·威尔德
Agrivane = 安格瓦
Maric Seaworth = 马利克·席渥斯
Riverbend = 河弯村
Red Jester = 红丑号
Ryella Royce = 蕾娅娜·罗伊斯
Dorren Stark = 多伦·史塔克
Hugo Vance = 雨果·凡斯
Jade Gates = 玉海之门
Meleys = 梅丽亚斯
Alysanne Osgrey = 亚莉珊·奥斯格雷
Beastmaster = 兽舍掌管
A Song of Ice and Fire = 冰与火之歌
Oldtown = 旧镇
Redfort = 红垒
Khal = 卡奥
House Massey = 马赛家族
Olenna Tyrell = 奥莲娜·雷德温
Bastardy = 私生子
Jyana = 健娜
Damon Morrigen = 达蒙·莫里根
Three Sisters = 三姐妹群岛
Runceford Redwyne = 伦赛佛德·雷德温
Alysanne Targaryen = 亚莉珊·坦格利安
Thistle = 大蓟
Tion Frey = 提恩·佛雷
Robin Hill = 罗宾·希山
Dothraki Sea = 多斯拉克海
Branston Cuy = 布兰顿·库伊
Hagen = 霍根
Roggo = 罗戈
Secret marriage pact = 秘密婚约
Adakhakileki = 阿达卡基拉基
Iron Victory = 无敌铁种号
Battle of the Camps = 袭营之战
Tytos Frey = 泰陀斯·佛雷
Hallis Mollen = 哈里斯·莫兰
Blackwood Vale = 布莱伍德谷
Fever River = 热浪河
Jeyne Arryn = 简妮·艾林
Jammos Frey = 杰莫斯·佛雷
Senelle = 塞蕾娜
Jarmen Buckwell = 贾曼·布克威尔
House Goodbrook = 古柏克家族
Lewys Lydden = 林斯·莱顿
Jeffory Norcross = 乔佛里·诺科斯
Beyond the Wall = 塞外
Durran = 杜伦
Martyn Cassel = 马丁·凯索
Tourney at Harrenhal = 赫伦堡比武大会
Cragorn = 克莱贡
Gallant Men = 侠客团
Quaro = 魁洛
Battle of Wendwater Bridge = 文德河桥之役
Drowned Men = 淹人
Quentyn Tarth = 昆廷·塔斯
Daznak's Pit = 达兹纳克竞技场
Gareth Tyrell = 加雷斯·提利尔
Doreah = 多莉亚
Joss the Gloom = "忧愁的"乔斯
Edric Stark = 艾德瑞克·史塔克
Shavepates = 圆颅党
Master of Ships = 海军上将
Lady of Silk = 丝绸夫人号
Gavin = 盖文
Aemon Targaryen = 伊蒙·坦格利安
Goodwin = 古德温
Aegon's high hill = 伊耿高丘
Ronnet Connington = 罗兰·克林顿
Torbert = 托伯特
Fairmarket = 美人集
Field of Fire = 怒火燎原
Grey Cliffs = 大峭壁
Master of Whisperers = 情报总管
Scourge = 祸江
Ricasso = 里卡索
Mountains of the Moon = 明月山脉
Cynthea Frey = 茜丝·佛雷
old shield rhyme = 盾牌四字歌
Morgan Dunstable = 莫甘·邓斯特布尔
Victarion Greyjoy = 维克塔利昂·葛雷乔伊
Drogon = 卓耿
Walder Brax = 瓦德·布拉克斯
Kurleket = 库雷凯特
Omer Blackberry = 欧麦·布莱伯利
Yorkel = 约克尔
Third Blackfyre Rebellion = 第三次黑火叛乱
Ghaen = 吉恩岛
Robert Frey = 劳勃·佛雷
White Walda Frey = 白瓦妲·佛雷
Tumbler's Falls = 翻斗瀑
Brandon Stark = 布兰登·史塔克
Bakkalon = 巴卡隆
Vulture's Roost = 鹰穴堡
Tourmaline Emperor = 碧玺帝
Honeywine = 蜜酒河
Bonifer Hasty = 博尼佛·哈斯提
Jeor Mormont = 杰奥·莫尔蒙
Steffon Hollard = 史蒂芬·霍拉德
Davos Baratheon = 戴佛斯·拜拉席恩
High Septon = 总主教
Lucantine Woodwright = 卢坎迪·伍德怀特
Haldon = 哈尔顿
Crossroads Inn = 十字路口客栈
House Marsh = 马尔锡家族
Sigrin = 西格林
Dyah = 妲娅
House Osgrey = 坚定堡的奥斯格雷家族
Merling King = 人鱼王
Dryn = 戴温
White Lady = 白色女士号
Ben (Big Belly) = 本恩(大肚子)
Donnor Stark = 多诺·史塔克
Tower of Ghosts = 厉鬼塔
Let Me Drink Your Beauty = 让我啜吸你的美丽
Brusco = 布鲁斯科
Meredyth Darklyn = 梅内狄斯·达克林
Prestayn = 普莱斯坦
Gretchel = 吉思尔
House Manwoody = 曼伍笛家族
Wolfsbane = 附子草
Robert Ashford = 劳勃·岑佛德
Shadowbinder = 缚影士
Dusky Roses = 黑蔷薇
Henly = 亨利
Vahar = 瓦哈尔
Greenapple = 绿苹果江
Bhakaz = 巴卡哈兹
Mirri Maz Duur = 弥丽·马兹·笃尔
Myrio Myrakis = 米利欧·密拉克斯
Ghost (constellation) = 鬼魂座
Kirth Vance = 凯司·凡斯
Urras Greyiron = 乌拉斯·葛雷艾恩
House Moreland = 摩兰德家族
Forktop = 叉梢
Brair = 荆棘
Stonesnake = 石蛇
Naerys Targaryen = 奈丽诗·坦格利安
Leobald Tallhart = 兰巴德·陶哈
Ocean Road = 滨海大道
Jinqi = 伊契
Ten Thousand Ships = 万船远航记
Marselen = 弥桑洛
Vardis Egen = 瓦狄斯·伊根
Lord's Mill = 领主坊
Brandon Norrey = 布兰登·诺瑞
Shatterstone = 碎石堡
House Hardyng = 哈顿家族
Tattered Prince = 褴衣亲王
Cregan Karstark = 克雷根·卡史塔克
Tion Lannister = 提恩·兰尼斯特
Lizard Head = 蜥蜴头
Monford Velaryon = 蒙福德·瓦列利安
Beans = 扁豆
Valar Morghulis = Valar Morghulis
Daggerleaf = 匕首叶
Tybolt Lannister = 泰伯特·兰尼斯特
House Crakehall = 克雷赫家族
House Trant = 特兰家族
Pebbleton = 卵石镇
House Fossoway of New Barrel = 新桶城的佛索威家族
Little Willow = 小柳江
Grey King = 灰海王
House Tollett = 托勒特家族
House Uller = 乌勒家族
Mero = 梅罗
Hag's Mire = 女巫沼泽
Currency = 货币
Gyleno Dothare = 吉勒诺·多塞尔
Sealord's Palace = 海王殿
Stannis Seaworth = 史坦尼斯·席渥斯
The Night That Ended = 终结长夜
Elwood = 埃伍德
Lives of Four Kings = 四王志
Mandon Moore = 曼登·穆尔
House Vikary = 维卡瑞家族
Sebastion Errol = 塞巴斯蒂安·埃洛尔
House Condon = 孔顿家族
Zia Frey = 佐妮·佛雷
House Kettleblack = 凯特布莱克家族
Jorgen = 约尔根
Ormond Osgrey = 奥蒙德·奥斯格雷
Errok = 埃洛克
Robert Stone = 劳勃·石东
Cregan Stark = 克雷根·史塔克
Black Knife = 黑刃
Giant's Lance = 巨人之枪
House Baelish = 贝里席家族
Threepenny Wood = 三钱林
Old Oak = 古橡城
Lewys Piper = 林斯·派柏
Walder Goodbrook = 瓦德·古柏克
Brandon Snow = 布兰登·雪诺
Rhaenys Targaryen = 雷妮丝·坦格利安
Viserys Targaryen = 韦赛里斯·坦格利安
Alicent Hightower = 阿莉森·海塔尔
